Turn,TotalAgents,EmpAgents,NonEmpAgents,AvgEmpEnergy,AvgNonEmpEnergy
1,40,14,26,17.142857142857142,17.26923076923077
2,79,27,52,23.074074074074073,21.78846153846154
3,144,49,95,26.571428571428573,25.157894736842106
4,255,88,167,24.306818181818183,23.347305389221557
5,363,126,237,20.936507936507937,19.670886075949365
6,392,138,254,20.028985507246375,19.488188976377952
7,398,141,257,19.68794326241135,19.35019455252918
8,400,142,258,19.570422535211268,19.294573643410853
9,400,142,258,19.577464788732396,19.290697674418606
10,400,142,258,19.577464788732396,19.286821705426355
11,400,142,258,19.577464788732396,19.282945736434108
12,400,142,258,19.577464788732396,19.27906976744186
13,400,142,258,19.577464788732396,19.275193798449614
14,400,142,258,19.577464788732396,19.271317829457363
15,400,142,258,19.577464788732396,19.267441860465116
16,400,142,258,19.577464788732396,19.26356589147287
17,400,142,258,19.577464788732396,19.25968992248062
18,399,142,257,19.577464788732396,19.330739299610894
19,399,142,257,19.577464788732396,19.330739299610894
20,399,142,257,19.577464788732396,19.330739299610894
21,399,142,257,19.577464788732396,19.330739299610894
22,399,142,257,19.577464788732396,19.330739299610894
23,399,142,257,19.577464788732396,19.330739299610894
24,399,142,257,19.577464788732396,19.330739299610894
25,399,142,257,19.577464788732396,19.330739299610894
26,399,142,257,19.577464788732396,19.330739299610894
27,399,142,257,19.577464788732396,19.330739299610894
28,399,142,257,19.577464788732396,19.330739299610894
29,399,142,257,19.577464788732396,19.330739299610894
30,399,142,257,19.577464788732396,19.330739299610894
31,399,142,257,19.577464788732396,19.330739299610894
32,399,142,257,19.577464788732396,19.330739299610894
33,399,142,257,19.577464788732396,19.330739299610894
34,399,142,257,19.577464788732396,19.330739299610894
35,399,142,257,19.577464788732396,19.330739299610894
36,399,142,257,19.577464788732396,19.330739299610894
37,399,142,257,19.577464788732396,19.330739299610894
38,399,142,257,19.577464788732396,19.330739299610894
39,399,142,257,19.577464788732396,19.330739299610894
40,399,142,257,19.577464788732396,19.330739299610894
41,399,142,257,19.577464788732396,19.330739299610894
42,399,142,257,19.577464788732396,19.330739299610894
43,399,142,257,19.577464788732396,19.330739299610894
44,399,142,257,19.577464788732396,19.330739299610894
45,399,142,257,19.577464788732396,19.330739299610894
46,399,142,257,19.577464788732396,19.330739299610894
47,399,142,257,19.577464788732396,19.330739299610894
48,399,142,257,19.577464788732396,19.330739299610894
49,399,142,257,19.577464788732396,19.330739299610894
50,399,142,257,19.577464788732396,19.330739299610894
51,399,142,257,19.577464788732396,19.330739299610894
52,399,142,257,19.577464788732396,19.330739299610894
53,399,142,257,19.577464788732396,19.330739299610894
54,399,142,257,19.577464788732396,19.330739299610894
55,399,142,257,19.577464788732396,19.330739299610894
56,399,142,257,19.577464788732396,19.330739299610894
57,399,142,257,19.577464788732396,19.330739299610894
58,399,142,257,19.577464788732396,19.330739299610894
59,399,142,257,19.577464788732396,19.330739299610894
60,399,142,257,19.577464788732396,19.330739299610894
61,399,142,257,19.577464788732396,19.330739299610894
62,399,142,257,19.577464788732396,19.330739299610894
63,399,142,257,19.577464788732396,19.330739299610894
64,399,142,257,19.577464788732396,19.330739299610894
65,399,142,257,19.577464788732396,19.330739299610894
66,399,142,257,19.577464788732396,19.330739299610894
67,399,142,257,19.577464788732396,19.330739299610894
68,399,142,257,19.577464788732396,19.330739299610894
69,399,142,257,19.577464788732396,19.330739299610894
70,399,142,257,19.577464788732396,19.330739299610894
71,399,142,257,19.577464788732396,19.330739299610894
72,399,142,257,19.577464788732396,19.330739299610894
73,399,142,257,19.577464788732396,19.330739299610894
74,399,142,257,19.577464788732396,19.330739299610894
75,399,142,257,19.577464788732396,19.330739299610894
76,399,142,257,19.577464788732396,19.330739299610894
77,399,142,257,19.577464788732396,19.330739299610894
78,399,142,257,19.577464788732396,19.330739299610894
79,399,142,257,19.577464788732396,19.330739299610894
80,399,142,257,19.577464788732396,19.330739299610894
81,399,142,257,19.577464788732396,19.330739299610894
82,399,142,257,19.577464788732396,19.330739299610894
83,399,142,257,19.577464788732396,19.330739299610894
84,399,142,257,19.577464788732396,19.330739299610894
85,399,142,257,19.577464788732396,19.330739299610894
86,399,142,257,19.577464788732396,19.330739299610894
87,399,142,257,19.577464788732396,19.330739299610894
88,399,142,257,19.577464788732396,19.330739299610894
89,399,142,257,19.577464788732396,19.330739299610894
90,399,142,257,19.577464788732396,19.330739299610894
91,399,142,257,19.577464788732396,19.330739299610894
92,399,142,257,19.577464788732396,19.330739299610894
93,399,142,257,19.577464788732396,19.330739299610894
94,399,142,257,19.577464788732396,19.330739299610894
95,399,142,257,19.577464788732396,19.330739299610894
96,399,142,257,19.577464788732396,19.330739299610894
97,399,142,257,19.577464788732396,19.330739299610894
98,399,142,257,19.577464788732396,19.330739299610894
99,399,142,257,19.577464788732396,19.330739299610894
100,399,142,257,19.577464788732396,19.330739299610894
101,399,142,257,19.577464788732396,19.330739299610894
102,399,142,257,19.577464788732396,19.330739299610894
103,399,142,257,19.577464788732396,19.330739299610894
104,399,142,257,19.577464788732396,19.330739299610894
105,399,142,257,19.577464788732396,19.330739299610894
106,399,142,257,19.577464788732396,19.330739299610894
107,399,142,257,19.577464788732396,19.330739299610894
108,399,142,257,19.577464788732396,19.330739299610894
109,399,142,257,19.577464788732396,19.330739299610894
110,399,142,257,19.577464788732396,19.330739299610894
111,399,142,257,19.577464788732396,19.330739299610894
112,399,142,257,19.577464788732396,19.330739299610894
113,399,142,257,19.577464788732396,19.330739299610894
114,399,142,257,19.577464788732396,19.330739299610894
115,399,142,257,19.577464788732396,19.330739299610894
116,399,142,257,19.577464788732396,19.330739299610894
117,399,142,257,19.577464788732396,19.330739299610894
118,399,142,257,19.577464788732396,19.330739299610894
119,399,142,257,19.577464788732396,19.330739299610894
120,399,142,257,19.577464788732396,19.330739299610894
121,399,142,257,19.577464788732396,19.330739299610894
122,399,142,257,19.577464788732396,19.330739299610894
123,399,142,257,19.577464788732396,19.330739299610894
124,399,142,257,19.577464788732396,19.330739299610894
125,399,142,257,19.577464788732396,19.330739299610894
126,399,142,257,19.577464788732396,19.330739299610894
127,399,142,257,19.577464788732396,19.330739299610894
128,399,142,257,19.577464788732396,19.330739299610894
129,399,142,257,19.577464788732396,19.330739299610894
130,399,142,257,19.577464788732396,19.330739299610894
131,399,142,257,19.577464788732396,19.330739299610894
132,399,142,257,19.577464788732396,19.330739299610894
133,399,142,257,19.577464788732396,19.330739299610894
134,399,142,257,19.577464788732396,19.330739299610894
135,399,142,257,19.577464788732396,19.330739299610894
136,399,142,257,19.577464788732396,19.330739299610894
137,399,142,257,19.577464788732396,19.330739299610894
138,399,142,257,19.577464788732396,19.330739299610894
139,399,142,257,19.577464788732396,19.330739299610894
140,399,142,257,19.577464788732396,19.330739299610894
141,399,142,257,19.577464788732396,19.330739299610894
142,399,142,257,19.577464788732396,19.330739299610894
143,399,142,257,19.577464788732396,19.330739299610894
144,399,142,257,19.577464788732396,19.330739299610894
145,399,142,257,19.577464788732396,19.330739299610894
146,399,142,257,19.577464788732396,19.330739299610894
147,399,142,257,19.577464788732396,19.330739299610894
148,399,142,257,19.577464788732396,19.330739299610894
149,399,142,257,19.577464788732396,19.330739299610894
150,399,142,257,19.577464788732396,19.330739299610894
151,399,142,257,19.577464788732396,19.330739299610894
152,399,142,257,19.577464788732396,19.330739299610894
153,399,142,257,19.577464788732396,19.330739299610894
154,399,142,257,19.577464788732396,19.330739299610894
155,399,142,257,19.577464788732396,19.330739299610894
156,399,142,257,19.577464788732396,19.330739299610894
157,399,142,257,19.577464788732396,19.330739299610894
158,399,142,257,19.577464788732396,19.330739299610894
159,399,142,257,19.577464788732396,19.330739299610894
160,399,142,257,19.577464788732396,19.330739299610894
161,399,142,257,19.577464788732396,19.330739299610894
162,399,142,257,19.577464788732396,19.330739299610894
163,399,142,257,19.577464788732396,19.330739299610894
164,399,142,257,19.577464788732396,19.330739299610894
165,399,142,257,19.577464788732396,19.330739299610894
166,399,142,257,19.577464788732396,19.330739299610894
167,399,142,257,19.577464788732396,19.330739299610894
168,399,142,257,19.577464788732396,19.330739299610894
169,399,142,257,19.577464788732396,19.330739299610894
170,399,142,257,19.577464788732396,19.330739299610894
171,399,142,257,19.577464788732396,19.330739299610894
172,399,142,257,19.577464788732396,19.330739299610894
173,399,142,257,19.577464788732396,19.330739299610894
174,399,142,257,19.577464788732396,19.330739299610894
175,399,142,257,19.577464788732396,19.330739299610894
176,399,142,257,19.577464788732396,19.330739299610894
177,399,142,257,19.577464788732396,19.330739299610894
178,399,142,257,19.577464788732396,19.330739299610894
179,399,142,257,19.577464788732396,19.330739299610894
180,399,142,257,19.577464788732396,19.330739299610894
181,399,142,257,19.577464788732396,19.330739299610894
182,399,142,257,19.577464788732396,19.330739299610894
183,399,142,257,19.577464788732396,19.330739299610894
184,399,142,257,19.577464788732396,19.330739299610894
185,399,142,257,19.577464788732396,19.330739299610894
186,399,142,257,19.577464788732396,19.330739299610894
187,399,142,257,19.577464788732396,19.330739299610894
188,399,142,257,19.577464788732396,19.330739299610894
189,399,142,257,19.577464788732396,19.330739299610894
190,399,142,257,19.577464788732396,19.330739299610894
191,399,142,257,19.577464788732396,19.330739299610894
192,399,142,257,19.577464788732396,19.330739299610894
193,399,142,257,19.577464788732396,19.330739299610894
194,399,142,257,19.577464788732396,19.330739299610894
195,399,142,257,19.577464788732396,19.330739299610894
196,399,142,257,19.577464788732396,19.330739299610894
197,399,142,257,19.577464788732396,19.330739299610894
198,399,142,257,19.577464788732396,19.330739299610894
199,399,142,257,19.577464788732396,19.330739299610894
200,399,142,257,19.577464788732396,19.330739299610894
201,399,142,257,19.577464788732396,19.330739299610894
202,399,142,257,19.577464788732396,19.330739299610894
203,399,142,257,19.577464788732396,19.330739299610894
204,399,142,257,19.577464788732396,19.330739299610894
205,399,142,257,19.577464788732396,19.330739299610894
206,399,142,257,19.577464788732396,19.330739299610894
207,399,142,257,19.577464788732396,19.330739299610894
208,399,142,257,19.577464788732396,19.330739299610894
209,399,142,257,19.577464788732396,19.330739299610894
210,399,142,257,19.577464788732396,19.330739299610894
211,399,142,257,19.577464788732396,19.330739299610894
212,399,142,257,19.577464788732396,19.330739299610894
213,399,142,257,19.577464788732396,19.330739299610894
214,399,142,257,19.577464788732396,19.330739299610894
215,399,142,257,19.577464788732396,19.330739299610894
216,399,142,257,19.577464788732396,19.330739299610894
217,399,142,257,19.577464788732396,19.330739299610894
218,399,142,257,19.577464788732396,19.330739299610894
219,399,142,257,19.577464788732396,19.330739299610894
220,399,142,257,19.577464788732396,19.330739299610894
221,399,142,257,19.577464788732396,19.330739299610894
222,399,142,257,19.577464788732396,19.330739299610894
223,399,142,257,19.577464788732396,19.330739299610894
224,399,142,257,19.577464788732396,19.330739299610894
225,399,142,257,19.577464788732396,19.330739299610894
226,399,142,257,19.577464788732396,19.330739299610894
227,399,142,257,19.577464788732396,19.330739299610894
228,399,142,257,19.577464788732396,19.330739299610894
229,399,142,257,19.577464788732396,19.330739299610894
230,399,142,257,19.577464788732396,19.330739299610894
231,399,142,257,19.577464788732396,19.330739299610894
232,399,142,257,19.577464788732396,19.330739299610894
233,399,142,257,19.577464788732396,19.330739299610894
234,399,142,257,19.577464788732396,19.330739299610894
235,399,142,257,19.577464788732396,19.330739299610894
236,399,142,257,19.577464788732396,19.330739299610894
237,399,142,257,19.577464788732396,19.330739299610894
238,399,142,257,19.577464788732396,19.330739299610894
239,399,142,257,19.577464788732396,19.330739299610894
240,399,142,257,19.577464788732396,19.330739299610894
241,399,142,257,19.577464788732396,19.330739299610894
242,399,142,257,19.577464788732396,19.330739299610894
243,399,142,257,19.577464788732396,19.330739299610894
244,399,142,257,19.577464788732396,19.330739299610894
245,399,142,257,19.577464788732396,19.330739299610894
246,399,142,257,19.577464788732396,19.330739299610894
247,399,142,257,19.577464788732396,19.330739299610894
248,399,142,257,19.577464788732396,19.330739299610894
249,399,142,257,19.577464788732396,19.330739299610894
250,399,142,257,19.577464788732396,19.330739299610894
251,399,142,257,19.577464788732396,19.330739299610894
252,399,142,257,19.577464788732396,19.330739299610894
253,399,142,257,19.577464788732396,19.330739299610894
254,399,142,257,19.577464788732396,19.330739299610894
255,399,142,257,19.577464788732396,19.330739299610894
256,399,142,257,19.577464788732396,19.330739299610894
257,399,142,257,19.577464788732396,19.330739299610894
258,399,142,257,19.577464788732396,19.330739299610894
259,399,142,257,19.577464788732396,19.330739299610894
260,399,142,257,19.577464788732396,19.330739299610894
261,399,142,257,19.577464788732396,19.330739299610894
262,399,142,257,19.577464788732396,19.330739299610894
263,399,142,257,19.577464788732396,19.330739299610894
264,399,142,257,19.577464788732396,19.330739299610894
265,399,142,257,19.577464788732396,19.330739299610894
266,399,142,257,19.577464788732396,19.330739299610894
267,399,142,257,19.577464788732396,19.330739299610894
268,399,142,257,19.577464788732396,19.330739299610894
269,399,142,257,19.577464788732396,19.330739299610894
270,399,142,257,19.577464788732396,19.330739299610894
271,399,142,257,19.577464788732396,19.330739299610894
272,399,142,257,19.577464788732396,19.330739299610894
273,399,142,257,19.577464788732396,19.330739299610894
274,399,142,257,19.577464788732396,19.330739299610894
275,399,142,257,19.577464788732396,19.330739299610894
276,399,142,257,19.577464788732396,19.330739299610894
277,399,142,257,19.577464788732396,19.330739299610894
278,399,142,257,19.577464788732396,19.330739299610894
279,399,142,257,19.577464788732396,19.330739299610894
280,399,142,257,19.577464788732396,19.330739299610894
281,399,142,257,19.577464788732396,19.330739299610894
282,399,142,257,19.577464788732396,19.330739299610894
283,399,142,257,19.577464788732396,19.330739299610894
284,399,142,257,19.577464788732396,19.330739299610894
285,399,142,257,19.577464788732396,19.330739299610894
286,399,142,257,19.577464788732396,19.330739299610894
287,399,142,257,19.577464788732396,19.330739299610894
288,399,142,257,19.577464788732396,19.330739299610894
289,399,142,257,19.577464788732396,19.330739299610894
290,399,142,257,19.577464788732396,19.330739299610894
291,399,142,257,19.577464788732396,19.330739299610894
292,399,142,257,19.577464788732396,19.330739299610894
293,399,142,257,19.577464788732396,19.330739299610894
294,399,142,257,19.577464788732396,19.330739299610894
295,399,142,257,19.577464788732396,19.330739299610894
296,399,142,257,19.577464788732396,19.330739299610894
297,399,142,257,19.577464788732396,19.330739299610894
298,399,142,257,19.577464788732396,19.330739299610894
299,399,142,257,19.577464788732396,19.330739299610894
300,399,142,257,19.577464788732396,19.330739299610894
301,399,142,257,19.577464788732396,19.330739299610894
302,399,142,257,19.577464788732396,19.330739299610894
303,399,142,257,19.577464788732396,19.330739299610894
304,399,142,257,19.577464788732396,19.330739299610894
305,399,142,257,19.577464788732396,19.330739299610894
306,399,142,257,19.577464788732396,19.330739299610894
307,399,142,257,19.577464788732396,19.330739299610894
308,399,142,257,19.577464788732396,19.330739299610894
309,399,142,257,19.577464788732396,19.330739299610894
310,399,142,257,19.577464788732396,19.330739299610894
311,399,142,257,19.577464788732396,19.330739299610894
312,399,142,257,19.577464788732396,19.330739299610894
313,399,142,257,19.577464788732396,19.330739299610894
314,399,142,257,19.577464788732396,19.330739299610894
315,399,142,257,19.577464788732396,19.330739299610894
316,399,142,257,19.577464788732396,19.330739299610894
317,399,142,257,19.577464788732396,19.330739299610894
318,399,142,257,19.577464788732396,19.330739299610894
319,399,142,257,19.577464788732396,19.330739299610894
320,399,142,257,19.577464788732396,19.330739299610894
321,399,142,257,19.577464788732396,19.330739299610894
322,399,142,257,19.577464788732396,19.330739299610894
323,399,142,257,19.577464788732396,19.330739299610894
324,399,142,257,19.577464788732396,19.330739299610894
325,399,142,257,19.577464788732396,19.330739299610894
326,399,142,257,19.577464788732396,19.330739299610894
327,399,142,257,19.577464788732396,19.330739299610894
328,399,142,257,19.577464788732396,19.330739299610894
329,399,142,257,19.577464788732396,19.330739299610894
330,399,142,257,19.577464788732396,19.330739299610894
331,399,142,257,19.577464788732396,19.330739299610894
332,399,142,257,19.577464788732396,19.330739299610894
333,399,142,257,19.577464788732396,19.330739299610894
334,399,142,257,19.577464788732396,19.330739299610894
335,399,142,257,19.577464788732396,19.330739299610894
336,399,142,257,19.577464788732396,19.330739299610894
337,399,142,257,19.577464788732396,19.330739299610894
338,399,142,257,19.577464788732396,19.330739299610894
339,399,142,257,19.577464788732396,19.330739299610894
340,399,142,257,19.577464788732396,19.330739299610894
341,399,142,257,19.577464788732396,19.330739299610894
342,399,142,257,19.577464788732396,19.330739299610894
343,399,142,257,19.577464788732396,19.330739299610894
344,399,142,257,19.577464788732396,19.330739299610894
345,399,142,257,19.577464788732396,19.330739299610894
346,399,142,257,19.577464788732396,19.330739299610894
347,399,142,257,19.577464788732396,19.330739299610894
348,399,142,257,19.577464788732396,19.330739299610894
349,399,142,257,19.577464788732396,19.330739299610894
350,399,142,257,19.577464788732396,19.330739299610894
351,399,142,257,19.577464788732396,19.330739299610894
352,399,142,257,19.577464788732396,19.330739299610894
353,399,142,257,19.577464788732396,19.330739299610894
354,399,142,257,19.577464788732396,19.330739299610894
355,399,142,257,19.577464788732396,19.330739299610894
356,399,142,257,19.577464788732396,19.330739299610894
357,399,142,257,19.577464788732396,19.330739299610894
358,399,142,257,19.577464788732396,19.330739299610894
359,399,142,257,19.577464788732396,19.330739299610894
360,399,142,257,19.577464788732396,19.330739299610894
361,399,142,257,19.577464788732396,19.330739299610894
362,399,142,257,19.577464788732396,19.330739299610894
363,399,142,257,19.577464788732396,19.330739299610894
364,399,142,257,19.577464788732396,19.330739299610894
365,399,142,257,19.577464788732396,19.330739299610894
366,399,142,257,19.577464788732396,19.330739299610894
367,399,142,257,19.577464788732396,19.330739299610894
368,399,142,257,19.577464788732396,19.330739299610894
369,399,142,257,19.577464788732396,19.330739299610894
370,399,142,257,19.577464788732396,19.330739299610894
371,399,142,257,19.577464788732396,19.330739299610894
372,399,142,257,19.577464788732396,19.330739299610894
373,399,142,257,19.577464788732396,19.330739299610894
374,399,142,257,19.577464788732396,19.330739299610894
375,399,142,257,19.577464788732396,19.330739299610894
376,399,142,257,19.577464788732396,19.330739299610894
377,399,142,257,19.577464788732396,19.330739299610894
378,399,142,257,19.577464788732396,19.330739299610894
379,399,142,257,19.577464788732396,19.330739299610894
380,399,142,257,19.577464788732396,19.330739299610894
381,399,142,257,19.577464788732396,19.330739299610894
382,399,142,257,19.577464788732396,19.330739299610894
383,399,142,257,19.577464788732396,19.330739299610894
384,399,142,257,19.577464788732396,19.330739299610894
385,399,142,257,19.577464788732396,19.330739299610894
386,399,142,257,19.577464788732396,19.330739299610894
387,399,142,257,19.577464788732396,19.330739299610894
388,399,142,257,19.577464788732396,19.330739299610894
389,399,142,257,19.577464788732396,19.330739299610894
390,399,142,257,19.577464788732396,19.330739299610894
391,399,142,257,19.577464788732396,19.330739299610894
392,399,142,257,19.577464788732396,19.330739299610894
393,399,142,257,19.577464788732396,19.330739299610894
394,399,142,257,19.577464788732396,19.330739299610894
395,399,142,257,19.577464788732396,19.330739299610894
396,399,142,257,19.577464788732396,19.330739299610894
397,399,142,257,19.577464788732396,19.330739299610894
398,399,142,257,19.577464788732396,19.330739299610894
399,399,142,257,19.577464788732396,19.330739299610894
400,399,142,257,19.577464788732396,19.330739299610894
401,399,142,257,19.577464788732396,19.330739299610894
402,399,142,257,19.577464788732396,19.330739299610894
403,399,142,257,19.577464788732396,19.330739299610894
404,399,142,257,19.577464788732396,19.330739299610894
405,399,142,257,19.577464788732396,19.330739299610894
406,399,142,257,19.577464788732396,19.330739299610894
407,399,142,257,19.577464788732396,19.330739299610894
408,399,142,257,19.577464788732396,19.330739299610894
409,399,142,257,19.577464788732396,19.330739299610894
410,399,142,257,19.577464788732396,19.330739299610894
411,399,142,257,19.577464788732396,19.330739299610894
412,399,142,257,19.577464788732396,19.330739299610894
413,399,142,257,19.577464788732396,19.330739299610894
414,399,142,257,19.577464788732396,19.330739299610894
415,399,142,257,19.577464788732396,19.330739299610894
416,399,142,257,19.577464788732396,19.330739299610894
417,399,142,257,19.577464788732396,19.330739299610894
418,399,142,257,19.577464788732396,19.330739299610894
419,399,142,257,19.577464788732396,19.330739299610894
420,399,142,257,19.577464788732396,19.330739299610894
421,399,142,257,19.577464788732396,19.330739299610894
422,399,142,257,19.577464788732396,19.330739299610894
423,399,142,257,19.577464788732396,19.330739299610894
424,399,142,257,19.577464788732396,19.330739299610894
425,399,142,257,19.577464788732396,19.330739299610894
426,399,142,257,19.577464788732396,19.330739299610894
427,399,142,257,19.577464788732396,19.330739299610894
428,399,142,257,19.577464788732396,19.330739299610894
429,399,142,257,19.577464788732396,19.330739299610894
430,399,142,257,19.577464788732396,19.330739299610894
431,399,142,257,19.577464788732396,19.330739299610894
432,399,142,257,19.577464788732396,19.330739299610894
433,399,142,257,19.577464788732396,19.330739299610894
434,399,142,257,19.577464788732396,19.330739299610894
435,399,142,257,19.577464788732396,19.330739299610894
436,399,142,257,19.577464788732396,19.330739299610894
437,399,142,257,19.577464788732396,19.330739299610894
438,399,142,257,19.577464788732396,19.330739299610894
439,399,142,257,19.577464788732396,19.330739299610894
440,399,142,257,19.577464788732396,19.330739299610894
441,399,142,257,19.577464788732396,19.330739299610894
442,399,142,257,19.577464788732396,19.330739299610894
443,399,142,257,19.577464788732396,19.330739299610894
444,399,142,257,19.577464788732396,19.330739299610894
445,399,142,257,19.577464788732396,19.330739299610894
446,399,142,257,19.577464788732396,19.330739299610894
447,399,142,257,19.577464788732396,19.330739299610894
448,399,142,257,19.577464788732396,19.330739299610894
449,399,142,257,19.577464788732396,19.330739299610894
450,399,142,257,19.577464788732396,19.330739299610894
451,399,142,257,19.577464788732396,19.330739299610894
452,399,142,257,19.577464788732396,19.330739299610894
453,399,142,257,19.577464788732396,19.330739299610894
454,399,142,257,19.577464788732396,19.330739299610894
455,399,142,257,19.577464788732396,19.330739299610894
456,399,142,257,19.577464788732396,19.330739299610894
457,399,142,257,19.577464788732396,19.330739299610894
458,399,142,257,19.577464788732396,19.330739299610894
459,399,142,257,19.577464788732396,19.330739299610894
460,399,142,257,19.577464788732396,19.330739299610894
461,399,142,257,19.577464788732396,19.330739299610894
462,399,142,257,19.577464788732396,19.330739299610894
463,399,142,257,19.577464788732396,19.330739299610894
464,399,142,257,19.577464788732396,19.330739299610894
465,399,142,257,19.577464788732396,19.330739299610894
466,399,142,257,19.577464788732396,19.330739299610894
467,399,142,257,19.577464788732396,19.330739299610894
468,399,142,257,19.577464788732396,19.330739299610894
469,399,142,257,19.577464788732396,19.330739299610894
470,399,142,257,19.577464788732396,19.330739299610894
471,399,142,257,19.577464788732396,19.330739299610894
472,399,142,257,19.577464788732396,19.330739299610894
473,399,142,257,19.577464788732396,19.330739299610894
474,399,142,257,19.577464788732396,19.330739299610894
475,399,142,257,19.577464788732396,19.330739299610894
476,399,142,257,19.577464788732396,19.330739299610894
477,399,142,257,19.577464788732396,19.330739299610894
478,399,142,257,19.577464788732396,19.330739299610894
479,399,142,257,19.577464788732396,19.330739299610894
480,399,142,257,19.577464788732396,19.330739299610894
481,399,142,257,19.577464788732396,19.330739299610894
482,399,142,257,19.577464788732396,19.330739299610894
483,399,142,257,19.577464788732396,19.330739299610894
484,399,142,257,19.577464788732396,19.330739299610894
485,399,142,257,19.577464788732396,19.330739299610894
486,399,142,257,19.577464788732396,19.330739299610894
487,399,142,257,19.577464788732396,19.330739299610894
488,399,142,257,19.577464788732396,19.330739299610894
489,399,142,257,19.577464788732396,19.330739299610894
490,399,142,257,19.577464788732396,19.330739299610894
491,399,142,257,19.577464788732396,19.330739299610894
492,399,142,257,19.577464788732396,19.330739299610894
493,399,142,257,19.577464788732396,19.330739299610894
494,399,142,257,19.577464788732396,19.330739299610894
495,399,142,257,19.577464788732396,19.330739299610894
496,399,142,257,19.577464788732396,19.330739299610894
497,399,142,257,19.577464788732396,19.330739299610894
498,399,142,257,19.577464788732396,19.330739299610894
499,399,142,257,19.577464788732396,19.330739299610894
500,399,142,257,19.577464788732396,19.330739299610894
